# deleted postag entries
#-------------------------------------------------------------------------------
# Do not add words here, but report them to languagetool@taaltik.nl
#-------------------------------------------------------------------------------
adviesplichtig	adviesplichtig	BNW:STL:VRB
afstandsbus	afstandsbus	ZNW:EKV
btw-plichtigen	btw-plichtigen	UNSPECIFIED
businessdoel	businessdoel	ZNW:EKV
chroomhoudende	chroomhoudende	BNW:STL:VRB
geleidingetjes	geleiding	ZNW:MRV:VRK:DE_
geleidinkje	geleiding	ZNW:EKV:VRK:HET
geleidinkjes	geleiding	ZNW:MRV:VRK:DE_
hulpvoertuig	hulpvoertuig	BNW:STL:ONV
hulpvoertuigs	hulpvoertuig	BNW:STL:IET
klantreis	klantreis	ZNW:EKV
krulmotief	krulmotief	ZNW:EKV
levensbestendig	levensbestendig	BNW:STL:VRB
pdf-files	pdf-files	ZNW:MRV:DE_
privé-berichten	privé-berichten	ZNW:MRV:DE_
teamscore	teamscore	ZNW:EKV
tv-inkomsten	tv-inkomsten	UNSPECIFIED
vingervlekken	vingervlekken	ZNW:MRV:DE_
zeedoel	zeedoel	UNSPECIFIED
